╒════════════╤════════════╕
│ ---------- │ ---------- │
├────────────┼────────────┤
│ ---------- │            │
├────────────┼────────────┤
│ ---------- │ ---------- │
╘════════════╧════════════╛