╒═══════════╤══════════════╕
│ Storage   │ Washroom     │
├───────────┼──────────────┤
│ Main Room │              │
├───────────┼──────────────┤
│ Utility   │ Medical Room │
╘═══════════╧══════════════╛